%%%%%%%%%%%%%%%%%
%    .         .%
%      .        %
%   %%%%%      .%
%P  G.. %.      %
%       %%%     %
%        .     .%
%%%%%%%%%%%%%%%%%