%%%%%%%%%%%%%%%%%
%o   .         .%
%      .        %
%   %%%%%      .%
%P  G.. %.      %
%       %%%     %
%        .     .%
%%%%%%%%%%%%%%%%%